R 15200 10800
NO textures/thijs.png
SO textures/wall_south.png
WE textures/wall_west.png
EA textures/wall_east.png
S textures/sprite.png
F 50,0,0
C 5,9,50


11111111111111111111111111111111111111111111111111111111111
10000000000000000000000000000000000000000000000000000000001
10000020000W00000000000000000000000000000000000000000000001
10000000000000000000000000000000000000000000000000000000001
10000000000000000000000000000000000000000000000000000000001
11111111111111111111111111111111111111111111111111111111111
